#####################################
# Datatypes              (KEYWORD1)
# Functions              (KEYWORD2)
# Structs                (KEYWORD3)
# Constants              (LITERAL1)
#####################################

# dmx/config.h is not public API.

# dmx/hal.h
ESP_DMX_VERSION_MAJOR	LITERAL1
ESP_DMX_VERSION_MINOR	LITERAL1
ESP_DMX_VERSION_PATCH	LITERAL1
ESP_DMX_VERSION_ID	LITERAL1
ESP_DMX_VERSION_LABEL	LITERAL1
DMX_CONFIG_DEFAULT	LITERAL1
DMX_SNIFFER_INTR_FLAGS_DEFAULT	LITERAL1
DMX_INTR_FLAGS_DEFAULT	LITERAL1
dmx_driver_install	KEYWORD2
dmx_driver_delete	KEYWORD2
dmx_driver_disable	KEYWORD2
dmx_driver_enable	KEYWORD2
dmx_set_pin	KEYWORD2
dmx_set_baud_rate	KEYWORD2
dmx_get_baud_rate	KEYWORD2
dmx_set_dmx_start_address	KEYWORD2
dmx_write_offset	KEYWORD2
dmx_receive	KEYWORD2
dmx_send	KEYWORD2
dmx_sniffer_enable	KEYWORD2
dmx_sniffer_disable	KEYWORD2

# dmx/nvs.h is not public API.

# dmx/struct.h is not public API.

# dmx/timer.h is not public API.

# dmx/types.h
DMX_PERSONALITY_COUNT_MAX	LITERAL1
dmx_start_code_is_valid	KEYWORD2
dmx_baud_rate_is_valid	KEYWORD2
dmx_break_len_is_valid	KEYWORD2
dmx_mab_len_is_valid	KEYWORD2
rdm_baud_rate_is_valid	KEYWORD2
rdm_break_len_is_valid	KEYWORD2
rdm_mab_len_is_valid	KEYWORD2
DMX_NUM_0	LITERAL1
DMX_NUM_1	LITERAL1
DMX_NUM_2	LITERAL1
DMX_PIN_NO_CHANGE	LITERAL1
DMX_PACKET_SIZE	LITERAL1
DMX_PACKET_SIZE_MAX	LITERAL1
DMX_BAUD_RATE	LITERAL1
DMX_BAUD_RATE_MIN	LITERAL1
DMX_BAUD_RATE_MAX	LITERAL1
DMX_BREAK_LEN_US	LITERAL1
DMX_BREAK_LEN_MIN_US	LITERAL1
DMX_BREAK_LEN_MAX_US	LITERAL1
DMX_MAB_LEN_US	LITERAL1
DMX_MAB_LEN_MIN_US	LITERAL1
DMX_MAB_LEN_MAX_US	LITERAL1
DMX_TIMEOUT_TICK	LITERAL1
RDM_BREAK_LEN_US	LITERAL1
RDM_BREAK_LEN_MIN_US	LITERAL1
RDM_BREAK_LEN_MAX_US	LITERAL1
RDM_MAB_LEN_US	LITERAL1
RDM_MAB_LEN_MIN_US	LITERAL1
RDM_MAB_LEN_MAX_US	LITERAL1
DMX_SC	LITERAL1
RDM_SC	LITERAL1
RDM_SUB_SC	LITERAL1
RDM_PREAMBLE	LITERAL1
RDM_DELIMITER	LITERAL1
DMX_TEXT_SC	LITERAL1
DMX_TEST_SC	LITERAL1
DMX_UTF8_SC	LITERAL1
DMX_ORG_ID_SC	LITERAL1
DMX_SIP_SC	LITERAL1
dmx_port_t	KEYWORD1
dmx_config_t	KEYWORD3
dmx_metadata_t	KEYWORD3
dmx_packet_t	KEYWORD3

# dmx/uart.h is not public API.

# dmx/utils.h is not public API.

# rdm/controller.h
rdm_disc_cb_t	KEYWORD1
rdm_send_disc_unique_branch	KEYWORD2
rdm_send_disc_mute	KEYWORD2
rdm_send_disc_un_mute	KEYWORD2
rdm_discover_with_callback	KEYWORD2
rdm_discover_devices_simple	KEYWORD2
rdm_send_get_device_info	KEYWORD2
rdm_send_get_software_version_label	KEYWORD2
rdm_send_get_identify_device	KEYWORD2
rdm_send_set_identify_device	KEYWORD2
rdm_send_get_dmx_start_address	KEYWORD2
rdm_send_set_dmx_start_address	KEYWORD2

# rdm/parameters.h
rdm_get_device_info	KEYWORD2
rdm_get_software_version_label	KEYWORD2
rdm_get_identify_device	KEYWORD2
rdm_set_identify_device	KEYWORD2
rdm_get_dmx_start_address	KEYWORD2
rdm_set_dmx_start_address	KEYWORD2

# rdm/responder.h
rdm_responder_cb_t	KEYWORD1
rdm_register_disc_unique_branch	KEYWORD2
rdm_register_disc_mute	KEYWORD2
rdm_register_disc_un_mute	KEYWORD2
rdm_register_device_info	KEYWORD2
rdm_register_software_version_label	KEYWORD2
rdm_register_identify_device	KEYWORD2
rdm_register_dmx_start_address	KEYWORD2

# rdm/types.h
rdm_uid_broadcast_man	KEYWORD2
UIDSTR	LITERAL1
UID2STR	LITERAL1
RDM_SUB_DEVICE_ROOT	LITERAL1
RDM_SUB_DEVICE_ALL	LITERAL1
RDM_CC_DISC_COMMAND	LITERAL1
RDM_CC_DISC_COMMAND_RESPONSE	LITERAL1
RDM_CC_GET_COMMAND	LITERAL1
RDM_CC_GET_COMMAND_RESPONSE	LITERAL1
RDM_CC_SET_COMMAND	LITERAL1
RDM_CC_SET_COMMAND_RESPONSE	LITERAL1
RDM_PID_DISC_UNIQUE_BRANCH	LITERAL1
RDM_PID_DISC_MUTE	LITERAL1
RDM_PID_DISC_UN_MUTE	LITERAL1
RDM_PID_PROXIED_DEVICES	LITERAL1
RDM_PID_PROXIED_DEVICE_COUNT	LITERAL1
RDM_PID_COMMS_STATUS	LITERAL1
RDM_PID_QUEUED_MESSAGE	LITERAL1
RDM_PID_STATUS_MESSAGE	LITERAL1
RDM_PID_STATUS_ID_DESCRIPTION	LITERAL1
RDM_PID_CLEAR_STATUS_ID	LITERAL1
RDM_PID_SUB_DEVICE_STATUS_REPORT_THRESHOLD	LITERAL1
RDM_PID_SUPPORTED_PARAMETERS	LITERAL1
RDM_PID_PARAMETER_DESCRIPTION	LITERAL1
RDM_PID_DEVICE_INFO	LITERAL1
RDM_PID_PRODUCT_DETAIL_ID_LIST	LITERAL1
RDM_PID_DEVICE_MODEL_DESCRIPTION	LITERAL1
RDM_PID_MANUFACTURER_LABEL	LITERAL1
RDM_PID_DEVICE_LABEL	LITERAL1
RDM_PID_FACTORY_DEFAULTS	LITERAL1
RDM_PID_LANGUAGE_CAPABILITIES	LITERAL1
RDM_PID_LANGUAGE	LITERAL1
RDM_PID_SOFTWARE_VERSION_LABEL	LITERAL1
RDM_PID_BOOT_SOFTWARE_VERSION_ID	LITERAL1
RDM_PID_BOOT_SOFTWARE_VERSION_LABEL	LITERAL1
RDM_PID_DMX_PERSONALITY	LITERAL1
RDM_PID_DMX_PERSONALITY_DESCRIPTION	LITERAL1
RDM_PID_DMX_START_ADDRESS	LITERAL1
RDM_PID_SLOT_INFO	LITERAL1
RDM_PID_SLOT_DESCRIPTION	LITERAL1
RDM_PID_DEFAULT_SLOT_VALUE	LITERAL1
RDM_PID_SENSOR_DEFINITION	LITERAL1
RDM_PID_SENSOR_VALUE	LITERAL1
RDM_PID_RECORD_SENSORS	LITERAL1
RDM_PID_DEVICE_HOURS	LITERAL1
RDM_PID_LAMP_HOURS	LITERAL1
RDM_PID_LAMP_STRIKES	LITERAL1
RDM_PID_LAMP_STATE	LITERAL1
RDM_PID_LAMP_ON_MODE	LITERAL1
RDM_PID_DEVICE_POWER_CYCLES	LITERAL1
RDM_PID_DISPLAY_INVERT	LITERAL1
RDM_PID_DISPLAY_LEVEL	LITERAL1
RDM_PID_PAN_INVERT	LITERAL1
RDM_PID_TILT_INVERT	LITERAL1
RDM_PID_PAN_TILT_SWAP	LITERAL1
RDM_PID_REAL_TIME_CLOCK	LITERAL1
RDM_PID_IDENTIFY_DEVICE	LITERAL1
RDM_PID_RESET_DEVICE	LITERAL1
RDM_PID_POWER_STATE	LITERAL1
RDM_PID_PERFORM_SELF_TEST	LITERAL1
RDM_PID_SELF_TEST_DESCRIPTION	LITERAL1
RDM_PID_CAPTURE_PRESET	LITERAL1
RDM_PID_PRESET_PLAYBACK	LITERAL1
RDM_RESPONSE_TYPE_INVALID	LITERAL1
RDM_RESPONSE_TYPE_NONE	LITERAL1
RDM_RESPONSE_TYPE_ACK	LITERAL1
RDM_RESPONSE_TYPE_ACK_TIMER	LITERAL1
RDM_RESPONSE_TYPE_NACK_REASON	LITERAL1
RDM_RESPONSE_TYPE_ACK_OVERFLOW	LITERAL1
RDM_STATUS_NONE	LITERAL1
RDM_STATUS_GET_LAST_MESSAGE	LITERAL1
RDM_STATUS_ADVISORY	LITERAL1
RDM_STATUS_WARNING	LITERAL1
RDM_STATUS_ERROR	LITERAL1
RDM_STATUS_ADVISORY_CLEARED	LITERAL1
RDM_STATUS_WARNING_CLEARED	LITERAL1
RDM_STATUS_ERROR_CLEARED	LITERAL1
RDM_NR_UNKNOWN_PID	LITERAL1
RDM_NR_FORMAT_ERROR	LITERAL1
RDM_NR_HARDWARE_FAULT	LITERAL1
RDM_NR_PROXY_REJECT	LITERAL1
RDM_NR_WRITE_PROTECT	LITERAL1
RDM_NR_UNSUPPORTED_COMMAND_CLASS	LITERAL1
RDM_NR_DATA_OUT_OF_RANGE	LITERAL1
RDM_NR_BUFFER_FULL	LITERAL1
RDM_NR_PACKET_SIZE_UNSUPPORTED	LITERAL1
RDM_NR_SUB_DEVICE_OUT_OF_RANGE	LITERAL1
RDM_NR_PROXY_BUFFER_FULL	LITERAL1
RDM_CC_DISC	LITERAL1
RDM_CC_GET	LITERAL1
RDM_CC_SET	LITERAL1
RDM_CC_GET_SET	LITERAL1
RDM_PRODUCT_CATEGORY_NOT_DECLARED	LITERAL1
RDM_PRODUCT_CATEGORY_FIXTURE	LITERAL1
RDM_PRODUCT_CATEGORY_FIXTURE_ACCESSORY	LITERAL1
RDM_PRODUCT_CATEGORY_PROJECTOR	LITERAL1
RDM_PRODUCT_CATEGORY_ATMOSPHERIC	LITERAL1
RDM_PRODUCT_CATEGORY_DIMMER	LITERAL1
RDM_PRODUCT_CATEGORY_POWER	LITERAL1
RDM_PRODUCT_CATEGORY_SCENIC	LITERAL1
RDM_PRODUCT_CATEGORY_DATA	LITERAL1
RDM_PRODUCT_CATEGORY_AV	LITERAL1
RDM_PRODUCT_CATEGORY_MONITOR	LITERAL1
RDM_PRODUCT_CATEGORY_CONTROL	LITERAL1
RDM_PRODUCT_CATEGORY_TEST	LITERAL1
RDM_PRODUCT_CATEGORY_OTHER	LITERAL1
RDM_DS_NOT_DEFINED	LITERAL1
RDM_DS_BIT_FIELD	LITERAL1
RDM_DS_ASCII	LITERAL1
RDM_DS_UNSIGNED_BYTE	LITERAL1
RDM_DS_SIGNED_BYTE	LITERAL1
RDM_DS_UNSIGNED_WORD	LITERAL1
RDM_DS_SIGNED_WORD	LITERAL1
RDM_DS_UNSIGNED_DWORD	LITERAL1
RDM_DS_SIGNED_DWORD	LITERAL1
RDM_UNITS_NONE	LITERAL1
RDM_PREFIX_NONE	LITERAL1
rdm_uid_t	KEYWORD1
rdm_ack_t	KEYWORD1
rdm_header_t	KEYWORD1
rdm_disc_unique_branch_t	KEYWORD3
rdm_disc_mute_t	KEYWORD3
rdm_device_info_t	KEYWORD3
rdm_pid_description_t	KEYWORD3
RDM_UID_BROADCAST_ALL	LITERAL1
RDM_UID_MAX	LITERAL1

# esp_dmx.h
dmx_driver_is_installed	KEYWORD2
dmx_driver_is_enabled	KEYWORD2
dmx_set_break_len	KEYWORD2
dmx_get_break_len	KEYWORD2
dmx_set_mab_len	KEYWORD2
dmx_get_mab_len	KEYWORD2
dmx_get_current_personality	KEYWORD2
dmx_set_current_personality	KEYWORD2
dmx_get_personality_count	KEYWORD2
dmx_get_footprint	KEYWORD2
dmx_get_personality_description	KEYWORD2
dmx_get_dmx_start_address	KEYWORD2
dmx_read_offset	KEYWORD2
dmx_read	KEYWORD2
dmx_read_slot	KEYWORD2
dmx_read_rdm	KEYWORD2
dmx_write	KEYWORD2
dmx_write_slot	KEYWORD2
dmx_write_rdm	KEYWORD2
dmx_wait_sent	KEYWORD2
dmx_sniffer_is_enabled	KEYWORD2
dmx_sniffer_get_data	KEYWORD2